Player,Team,Position,Winning_Team,Season,Games_Missed,Playtime_Before,Playtime_After,Playtime_Lost
A.J. Bouye,Houston Texans,Cornerback,1,2015/2016,1,28,16,12
A.J. Jefferson,Minnesota Vikings,Cornerback,1,2012/2013,0,40,84,-44
A.J. Klein,Carolina Panthers,Linebacker,1,2015/2016,1,63,22,41
Aaron Lynch,San Francisco 49ers,Linebacker,1,2015/2016,2,62,59,3
Aaron Williams,Buffalo Bills,Safety,1,2014/2015,0,71,87,-16
Ace Sanders,Jacksonville Jaguars,Wide Receiver,0,2013/2014,1,50,5,45
Adrian Robinson,Pittsburgh Steelers,Linebacker,1,2012/2013,0,3,7,-4
Ahmad Brooks,San Francisco 49ers,Linebacker,1,2015/2016,1,57,50,7
AJ Tarpley,Buffalo Bills,Linebacker,0,2015/2016,0,12,15,-3
Aldrick Robinson,Washington Redskins,Wide Receiver,1,2012/2013,1,37,14,23
Alex Green,Green Bay Packers,Running Back,1,2012/2013,2,30,1,29
Alex Smith,San Francisco 49ers,Quarterback,0,2012/2013,6,57,6,51
Alex Smith,Cincinnati Bengals,Tight End,1,2013/2014,0,31,37,-6
Alex Smith,Cleveland Browns,Tight End,0,2012/2013,3,43,14,29
Allen Hurns,Jacksonville Jaguars,Wide Receiver,0,2015/2016,1,61,42,19
Amari Spievey,Detroit Lions,Safety,0,2012/2013,10,53,0,53
Andre Brown,New York Giants,Running Back,1,2012/2013,1,36,25,11
Andre Brown,New York Giants,Running Back,1,2013/2014,1,47,28,19
Andre Fluellen,Detroit Lions,Defensive Tackle,0,2013/2014,0,16,19,-3
Andre Johnson,Houston Texans,Wide Receiver,1,2013/2014,0,71,41,30
Andre Smith,Cincinnati Bengals,Tackle,1,2015/2016,2,71,76,-5
Andrew Hawkins,Cleveland Browns,Wide Receiver,0,2015/2016,6,53,0,53
Andrew Hawkins,Cleveland Browns,Wide Receiver,0,2015/2016,2,56,46,10
Andrew Whitworth,Cincinnati Bengals,Defensive End,0,2013/2014,0,69,83,-14
Andrew Whitworth,Cincinnati Bengals,Tackle,1,2012/2013,0,70,68,2
Andrus Peat,New Orleans Saints,Tackle,1,2015/2016,1,35,0,35
Andy Gallik,Tennessee Titans,Center,0,2015/2016,1,17,71,-54
Anthony Allen,Baltimore Ravens,Running Back,0,2012/2013,0,23,19,4
Anthony Allen,Baltimore Ravens,Running Back,1,2012/2013,0,24,16,8
Anthony Fasano,Tennessee Titans,Tight End,0,2015/2016,0,43,27,16
Anthony Fasano,Kansas City Chiefs,Tight End,0,2013/2014,2,60,53,7
Antoine Caldwell,Houston Texans,Guard,0,2012/2013,0,48,48,0
Antonio Allen,New York Jets,Safety,1,2013/2014,0,53,6,47
Antonio Brown,Pittsburgh Steelers,Wide Receiver,1,2015/2016,1,68,0,68
Antrel Rolle,New York Giants,Safety,1,2012/2013,0,63,70,-7
Arthur Jones,Baltimore Ravens,Defensive Tackle,0,2013/2014,1,41,0,41
Asa Jackson,Baltimore Ravens,Cornerback,1,2014/2015,0,57,71,-14
Barry Richardson,St. Louis Rams,Tackle,0,2012/2013,0,66,88,-22
Ben Roethlisberger,Pittsburgh Steelers,Quarterback,0,2015/2016,0,63,73,-10
Benardrick McKinney,Houston Texans,Linebacker,1,2015/2016,2,38,42,-4
Benjamin Watson,New Orleans Saints,Tight End,1,2013/2014,1,41,27,14
Bernard Pierce,Baltimore Ravens,Running Back,0,2012/2013,0,13,22,-9
Bernard Pierce,Jacksonville Jaguars,Running Back,0,2015/2016,1,27,21,6
Bilal Powell,New York Jets,Running Back,0,2012/2013,0,31,28,3
Bill Bentley,Detroit Lions,Cornerback,0,2013/2014,1,48,0,48
Billy Bajema,Baltimore Ravens,Tight End,0,2012/2013,0,22,10,12
Billy Winn,Cleveland Browns,Defensive Tackle,0,2012/2013,0,69,56,13
BJ Raji,Green Bay Packers,Defensive Tackle,0,2015/2016,0,34,26,8
Blidi Wreh-Wilson,Tennessee Titans,Cornerback,0,2014/2015,1,78,90,-12
Bobby McCain,Miami Dolphins,Cornerback,0,2015/2016,0,34,37,-3
Bradley McDougald,Tampa Bay Buccaneers,Safety,0,2015/2016,0,68,59,9
Brady Quinn,Kansas City Chiefs,Quarterback,0,2012/2013,2,39,30,9
Brandin Cooks,New Orleans Saints,Wide Receiver,0,2015/2016,0,61,59,2
Brandon Bostick,Green Bay Packers,Tight End,0,2013/2014,1,27,26,1
Brandon Boykin,Philadelphia Eagles,Cornerback,0,2013/2014,0,59,53,6
Brandon Flowers,San Diego Chargers,Cornerback,0,2014/2015,1,54,59,-5
Brandon Flowers,San Diego Chargers,Cornerback,1,2015/2016,0,60,61,-1
Brandon Fusco,Minnesota Vikings,Guard,1,2015/2016,0,58,62,-4
Brandon LaFell,Carolina Panthers,Wide Receiver,0,2012/2013,1,57,70,-13
Brandon Myers,Oakland Raiders,Tight End,1,2012/2013,0,68,67,1
Brandon Weeden,Cleveland Browns,Quarterback,0,2013/2014,4,54,0,54
Brandon Weeden,Cleveland Browns,Quarterback,1,2012/2013,0,65,68,-3
Brent Celek,Philadelphia Eagles,Tight End,1,2012/2013,1,67,64,3
Brian Cushing,Houston Texans,Linebacker,0,2013/2014,0,66,50,16
Brian Hartline,Cleveland Browns,Wide Receiver,0,2015/2016,1,35,44,-9
Brian Hoyer,Houston Texans,Quarterback,1,2015/2016,1,60,70,-10
Brian Hoyer,Houston Texans,Quarterback,0,2015/2016,2,61,76,-15
Brittan Golden,Arizona Cardinals,Wide Receiver,1,2015/2016,0,21,19,2
Brodrick Bunkley,New Orleans Saints,Defensive Tackle,0,2014/2015,0,28,24,4
Bruce Carter,Tampa Bay Buccaneers,Linebacker,0,2015/2016,1,27,84,-57
Bryan Stork,New England Patriots,Center,1,2014/2015,1,42,82,-40
Bryan Walters,Seattle Seahawks,Wide Receiver,0,2014/2015,2,17,10,7
Bryan Walters,Jacksonville Jaguars,Wide Receiver,1,2015/2016,0,38,17,21
Bryce Callahan,Chicago Bears,Cornerback,1,2015/2016,0,13,74,-61
Buster Skrine,New York Jets,Cornerback,1,2015/2016,0,60,42,18
Buster Skrine,Cleveland Browns,Cornerback,0,2012/2013,0,66,55,11
Carlos Dunlap,Cincinnati Bengals,Defensive End,0,2013/2014,0,60,44,16
Case Keenum,St. Louis Rams,Quarterback,0,2015/2016,2,5,55,-50
Casey Hayward,Green Bay Packers,Cornerback,0,2015/2016,0,70,58,12
Cecil Shorts,Jacksonville Jaguars,Wide Receiver,0,2012/2013,1,43,62,-19
Charlie Peprah,Dallas Cowboys,Safety,1,2012/2013,0,55,32,23
Chaz Schilens,New York Jets,Wide Receiver,0,2012/2013,0,44,43,1
Chris Culliver,San Francisco 49ers,Cornerback,1,2014/2015,0,24,59,-35
Chris Harris,Denver Broncos,Cornerback,1,2013/2014,0,71,68,3
Chris Ogbonnaya,Cleveland Browns,Running Back,1,2013/2014,0,53,55,-2
Chris Owusu,New York Jets,Wide Receiver,0,2015/2016,10,54,0,54
Chris Watt,San Diego Chargers,Center,0,2015/2016,2,51,2,49
Chris Williams,St. Louis Rams,Guard,1,2013/2014,0,63,72,-9
Christian Ponder,Minnesota Vikings,Quarterback,1,2013/2014,4,61,0,61
Christopher Conte,Chicago Bears,Safety,0,2014/2015,0,42,26,16
Christopher Owens,Atlanta Falcons,Cornerback,1,2012/2013,2,32,21,11
Clyde Gates,New York Jets,Wide Receiver,0,2012/2013,2,22,17,5
Cody Davis,St. Louis Rams,Safety,0,2014/2015,1,21,22,-1
Colin McCarthy,Tennessee Titans,Linebacker,0,2012/2013,5,59,0,59
Cooper Taylor,New York Giants,Safety,0,2015/2016,2,23,0,23
Corey Graham,Buffalo Bills,Safety,1,2015/2016,0,0,99,-99
Corey Liuget,San Diego Chargers,Defensive End,1,2014/2015,0,47,27,20
Coty Sensabaugh,Tennessee Titans,Cornerback,0,2013/2014,0,48,45,3
Craig Dahl,New York Giants,Safety,0,2015/2016,1,53,0,53
Craig Dahl,St. Louis Rams,Safety,1,2012/2013,0,81,75,6
Craig Steltz,Chicago Bears,Safety,1,2013/2014,0,20,16,4
Craig Stevens,Tennessee Titans,Tight End,1,2013/2014,1,44,15,29
Craig Stevens,Tennessee Titans,Tight End,1,2012/2013,0,47,53,-6
Craig Stevens,Tennessee Titans,Tight End,0,2012/2013,1,52,0,52
D.J. Fluker,San Diego Chargers,Guard,0,2015/2016,2,71,79,-8
D.J. Fluker,San Diego Chargers,Guard,0,2015/2016,0,73,60,13
D.J. Fluker,San Diego Chargers,Tackle,0,2013/2014,1,74,78,-4
D'Qwell Jackson,Cleveland Browns,Linebacker,0,2012/2013,0,84,75,9
Da'Quan Bowers,Tampa Bay Buccaneers,Defensive End,1,2013/2014,1,19,19,0
Damian Swann,New Orleans Saints,Cornerback,1,2015/2016,4,37,25,12
Damian Swann,New Orleans Saints,Cornerback,0,2015/2016,2,43,54,-11
Dan Connolly,New England Patriots,Guard,1,2014/2015,1,73,71,2
Dan Connolly,New England Patriots,Guard,1,2013/2014,1,75,80,-5
Daniel Kilgore,San Francisco 49ers,Guard,1,2012/2013,0,14,8,6
Daniel Thomas,Miami Dolphins,Running Back,1,2012/2013,1,36,49,-13
Danny Amendola,New England Patriots,Wide Receiver,1,2013/2014,1,48,38,10
Danny Trevathan,Denver Broncos,Linebacker,1,2015/2016,1,53,62,-9
Darcel McBath,San Francisco 49ers,Safety,1,2012/2013,0,21,20,1
Darelle Revis,New York Jets,Cornerback,0,2015/2016,2,70,61,9
Daren Bates,St. Louis Rams,Linebacker,1,2013/2014,1,20,17,3
Darius Slay,Detroit Lions,Cornerback,0,2015/2016,0,65,90,-25
Darrell Stuckey,San Diego Chargers,Safety,1,2013/2014,0,21,19,2
Darren Sproles,New Orleans Saints,Running Back,0,2013/2014,0,32,37,-5
Darren Waker,Baltimore Ravens,Wide Receiver,0,2015/2016,1,26,5,21
Darrius Heyward-Bey,Oakland Raiders,Wide Receiver,1,2012/2013,1,57,50,7
David Amerson,Washington Redskins,Cornerback,0,2013/2014,0,65,32,33
David Amerson,Washington Redskins,Cornerback,0,2014/2015,0,73,59,14
De'Anthony Thomas,Kansas City Chiefs,Wide Receiver,1,2015/2016,8,26,0,26
DeAndre Hopkins,Houston Texans,Wide Receiver,0,2015/2016,0,77,86,-9
Dee Ford,Kansas City Chiefs,Linebacker,1,2015/2016,0,33,35,-2
Delanie Walker,Tennessee Titans,Tight End,0,2013/2014,1,55,77,-22
Demarcus Dobbs,Seattle Seahawks,Defensive End,1,2015/2016,2,20,17,3
Denico Autry,Oakland Raiders,Defensive End,0,2015/2016,2,57,58,-1
Dennis Pitta,Baltimore Ravens,Tight End,1,2012/2013,0,46,85,-39
Deone Bucannon,Arizona Cardinals,Safety,1,2015/2016,0,69,39,30
Devin Hester,Chicago Bears,Wide Receiver,1,2012/2013,1,37,61,-24
Devin McCourty,New England Patriots,Safety,1,2013/2014,1,84,78,6
Devin Street,Dallas Cowboys,Wide Receiver,0,2015/2016,0,22,15,7
Devonta Freeman,Atlanta Falcons,Running Back,0,2015/2016,1,56,48,8
Dexter McCluster,Kansas City Chiefs,Wide Receiver,0,2012/2013,0,40,24,16
Dion Sims,Miami Dolphins,Tight End,1,2015/2016,3,5,38,-33
Domenik Hixon,New York Giants,Wide Receiver,1,2012/2013,1,29,62,-33
Dominique Rodgers-Cromartie,New York Giants,Cornerback,0,2015/2016,1,72,74,-2
Donald Brown,San Diego Chargers,Linebacker,1,2014/2015,3,44,20,24
Donald Jones,Buffalo Bills,Wide Receiver,0,2012/2013,0,59,45,14
Donnie Avery,Indianapolis Colts,Wide Receiver,0,2012/2013,0,66,71,-5
Donte Whitner,Cleveland Browns,Safety,0,2015/2016,2,69,58,11
Drayton Florence,Detroit Lions,Cornerback,0,2012/2013,0,46,84,-38
Dre Kirkpatrick,Cincinnati Bengals,Cornerback,1,2012/2013,4,22,0,22
Duane Brown,Houston Texans,Tackle,1,2015/2016,0,81,65,16
Duke Ihenacho,Denver Broncos,Safety,1,2013/2014,0,57,45,12
Duke Johnson,Cleveland Browns,Running Back,1,2015/2016,0,0,0,0
Dunta Robinson,Atlanta Falcons,Cornerback,0,2012/2013,0,62,63,-1
Dwayne Bowe,Kansas City Chiefs,Wide Receiver,0,2013/2014,1,56,71,-15
Dwayne Gratz,Jacksonville Jaguars,Cornerback,0,2014/2015,1,85,28,57
Dwight Lowery,Jacksonville Jaguars,Safety,0,2013/2014,13,63,0,63
Earl Bennett,Chicago Bears,Wide Receiver,0,2012/2013,2,41,31,10
Early Doucet,Arizona Cardinals,Wide Receiver,0,2012/2013,3,43,0,43
Eddie Goldman,Chicago Bears,Defensive Tackle,0,2015/2016,0,0,0,0
Eddie Lacy,Green Bay Packers,Running Back,0,2014/2015,0,31,55,-24
Eddie Lacy,Green Bay Packers,Running Back,1,2013/2014,1,41,54,-13
Elbert Mack,New Orleans Saints,Cornerback,1,2012/2013,1,6,39,-33
Ellis Lankster,New York Jets,Cornerback,0,2012/2013,1,41,0,41
Emmanuel Lamur,Cincinnati Bengals,Linebacker,1,2014/2015,1,82,99,-17
Eric Fisher,Kansas City Chiefs,Tackle,1,2013/2014,1,75,67,8
Eric Martin,New England Patriots,Linebacker,1,2015/2016,5,18,0,18
Eric Reid,San Francisco 49ers,Safety,0,2013/2014,0,67,77,-10
Eric Reid,San Francisco 49ers,Safety,0,2013/2014,0,68,75,-7
Eric Rowe,Philadelphia Eagles,Defensive Back,0,2015/2016,0,37,83,-46
Eric Weddle,San Diego Chargers,Safety,0,2012/2013,0,76,90,-14
Eric Weems,Atlanta Falcons,Wide Receiver,0,2015/2016,0,19,8,11
Eric Wright,Tampa Bay Buccaneers,Cornerback,0,2012/2013,0,63,68,-5
Erin Henderson,Minnesota Vikings,Linebacker,0,2012/2013,2,83,20,63
Ernie Sims,Dallas Cowboys,Linebacker,1,2012/2013,0,54,20,34
Ethan Westbrooks,St. Louis Rams,Defensive End,1,2015/2016,0,26,37,-11
Eugene Monroe,Baltimore Ravens,Tackle,0,2015/2016,3,0,75,-75
Eugene Sims,St. Louis Rams,Defensive End,1,2012/2013,1,49,36,13
Fernando Velasco,Tennessee Titans,Center,0,2012/2013,0,67,59,8
Fletcher Cox,Philadelphia Eagles,Defensive Tackle,0,2012/2013,1,42,0,42
Fred Jackson,Buffalo Bills,Running Back,0,2012/2013,1,30,32,-2
Garrett Celek,San Francisco 49ers,Tight End,0,2015/2016,0,53,47,6
Garrett Graham,Houston Texans,Tight End,1,2012/2013,0,46,46,0
Garrett Graham,Houston Texans,Tight End,1,2012/2013,1,50,46,4
George Iloka,Cincinnati Bengals,Safety,1,2013/2014,0,70,63,7
George Selvie,Jacksonville Jaguars,Defensive End,0,2012/2013,2,33,30,3
George Selvie,New York Giants,Defensive End,1,2015/2016,1,39,37,2
George Selvie,Dallas Cowboys,Defensive End,0,2013/2014,0,46,66,-20
Gino Gradkowski,Baltimore Ravens,Guard,1,2012/2013,0,12,5,7
Glenn Winston,Cleveland Browns,Running Back,1,2015/2016,3,13,0,13
Glover Quin,Detroit Lions,Safety,1,2015/2016,0,67,66,1
Harrison Smith,Minnesota Vikings,Safety,0,2012/2013,0,73,92,-19
Husain Abdullah,Kansas City Chiefs,Safety,1,2015/2016,5,52,37,15
Ike Taylor,Pittsburgh Steelers,Cornerback,0,2013/2014,0,70,69,1
Isa Abdul-Quddus,New Orleans Saints,Safety,0,2012/2013,1,46,86,-40
Isaac Redman,Pittsburgh Steelers,Running Back,0,2012/2013,0,29,5,24
J.J. Jansen,Carolina Panthers,Safety,1,2015/2016,0,11,11,0
J.R. Sweezy,Seattle Seahawks,Guard,1,2013/2014,1,72,72,0
Jabari Greer,New Orleans Saints,Cornerback,1,2012/2013,1,62,0,62
Jacob Lacey,Detroit Lions,Cornerback,1,2012/2013,2,56,56,0
Jacob Tamme,Atlanta Falcons,Tight End,1,2015/2016,1,61,63,-2
Jacquizz Rodgers,Atlanta Falcons,Running Back,0,2013/2014,1,40,0,40
Jahleel Addae,San Diego Chargers,Safety,0,2015/2016,0,52,72,-20
Jake Fisher,Cincinnati Bengals,Guard,1,2015/2016,1,11,11,0
Jake Long,St. Louis Rams,Tackle,0,2013/2014,0,67,56,11
Jamari Lattimore,New York Jets,Linebacker,1,2015/2016,0,0,0,0
James Harrison,Cincinnati Bengals,Linebacker,0,2013/2014,1,31,27,4
Janoris Jenkins,St. Louis Rams,Cornerback,0,2015/2016,1,76,85,-9
Jarius Wright,Minnesota Vikings,Wide Receiver,1,2015/2016,0,27,24,3
Jarvis Jones,Pittsburgh Steelers,Linebacker,1,2013/2014,1,57,14,43
Jason Campbell,Cleveland Browns,Quarterback,0,2013/2014,1,51,74,-23
Jason Fox,Miami Dolphins,Tackle,1,2015/2016,3,0,0,0
Jason Hatcher,Dallas Cowboys,Defensive Tackle,0,2012/2013,0,46,54,-8
Jason Pinkston,Cleveland Browns,Guard,0,2013/2014,1,60,0,60
Jason Snelling,Atlanta Falcons,Running Back,0,2013/2014,0,34,28,6
Javier Arenas,Kansas City Chiefs,Cornerback,0,2012/2013,0,33,72,-39
Jay Cutler,Chicago Bears,Quarterback,0,2012/2013,1,64,73,-9
Jay Ratliff,Chicago Bears,Defensive Tackle,1,2014/2015,3,55,41,14
Jayron Hosley,New York Giants,Cornerback,1,2015/2016,0,55,18,37
Jeff Allen,Kansas City Chiefs,Guard,0,2012/2013,0,51,68,-17
Jeff Cumberland,New York Jets,Tight End,0,2015/2016,1,33,33,0
Jeff Cumberland,New York Jets,Tight End,0,2013/2014,1,45,51,-6
Jeff Maehl,Philadelphia Eagles,Wide Receiver,1,2013/2014,0,14,6,8
Jerel Worthy,Green Bay Packers,Defensive End,1,2012/2013,1,54,22,32
Jeremy Kerley,New York Jets,Wide Receiver,1,2015/2016,0,0,0,0
Jeremy Maclin,Kansas City Chiefs,Wide Receiver,0,2015/2016,1,66,53,13
Jeremy Mincey,Jacksonville Jaguars,Defensive End,0,2013/2014,3,30,21,9
Jeremy Mincey,Dallas Cowboys,Defensive End,1,2015/2016,1,43,51,-8
Jermaine Kearse,Seattle Seahawks,Linebacker,1,2013/2014,0,40,64,-24
Jermichael Finley,Green Bay Packers,Tight End,0,2013/2014,0,51,45,6
Jermon Bushrod,Chicago Bears,Tackle,0,2015/2016,4,80,4,76
Jeron Johnson,Seattle Seahawks,Safety,1,2014/2015,1,24,75,-51
Jerrell Freeman,Indianapolis Colts,Linebacker,0,2013/2014,0,57,78,-21
Jimmy Clausen,Chicago Bears,Quarterback,1,2015/2016,0,0,0,0
Jimmy Smith,Baltimore Ravens,Cornerback,1,2013/2014,0,68,65,3
Joe Haden,Cleveland Browns,Cornerback,1,2015/2016,8,75,0,75
Joe Haden,Cleveland Browns,Cornerback,0,2015/2016,2,75,45,30
Joe Reitz,Indianapolis Colts,Guard,1,2013/2014,3,15,0,15
Joe Reitz,Indianapolis Colts,Guard,1,2012/2013,1,59,0,59
Joe Reitz,Indianapolis Colts,Guard,1,2012/2013,1,66,64,2
Joe Staley,San Francisco 49ers,Tackle,0,2012/2013,0,67,61,6
Joe Webb,Minnesota Vikings,Wide Receiver,1,2013/2014,0,23,6,17
John Carlson,Minnesota Vikings,Tight End,1,2012/2013,2,23,12,11
John Carlson,Minnesota Vikings,Tight End,0,2013/2014,3,45,0,45
John Jenkins,New Orleans Saints,Defensive Tackle,0,2015/2016,2,43,26,17
John Jerry,Miami Dolphins,Guard,1,2013/2014,0,68,69,-1
John Lotulelei,Jacksonville Jaguars,Linebacker,0,2015/2016,1,26,49,-23
John Sullivan,Minnesota Vikings,Center,0,2013/2014,0,62,86,-24
John Sullivan,Minnesota Vikings,Center,0,2014/2015,0,63,74,-11
Johnathan Cyprien,Jacksonville Jaguars,Safety,0,2014/2015,1,37,78,-41
Johnathan Franklin,Green Bay Packers,Running Back,0,2013/2014,5,14,0,14
Johnny Manziel,Cleveland Browns,Quarterback,0,2015/2016,1,46,0,46
Johnny Patrick,San Diego Chargers,Cornerback,0,2013/2014,0,51,43,8
Johnny White,Green Bay Packers,Running Back,0,2012/2013,7,12,0,12
Joique Bell,Detroit Lions,Running Back,1,2014/2015,2,38,46,-8
Jon Baldwin,Kansas City Chiefs,Wide Receiver,0,2012/2013,1,39,26,13
Jon Beason,New York Giants,Linebacker,1,2015/2016,0,30,38,-8
Jordan Cameron,Cleveland Browns,Tight End,0,2012/2013,2,30,0,30
Jordan Cameron,Cleveland Browns,Tight End,0,2013/2014,1,68,39,29
Jordan Pugh,Washington Redskins,Safety,1,2012/2013,0,13,43,-30
Jordan Reed,Washington Redskins,Tight End,0,2013/2014,6,48,0,48
Jordan Reed,Washington Redskins,Tight End,1,2015/2016,2,63,38,25
Joseph Randle,Dallas Cowboys,Running Back,1,2014/2015,0,3,9,-6
Josh Andrews,Philadelphia Eagles,Center,0,2015/2016,1,5,3,2
Josh Evans,Jacksonville Jaguars,Safety,0,2015/2016,0,41,44,-3
Josh Hill,New Orleans Saints,Tight End,0,2015/2016,0,46,44,2
Josh Huff,Philadelphia Eagles,Wide Receiver,0,2015/2016,0,44,36,8
Josh McNary,Indianapolis Colts,Linebacker,1,2013/2014,0,38,38,0
Josh Norman,Carolina Panthers,Cornerback,1,2014/2015,2,32,71,-39
Josh Robinson,Minnesota Vikings,Cornerback,1,2015/2016,1,15,9,6
Josh Sitton,Green Bay Packers,Guard,1,2012/2013,0,74,70,4
Josh Thomas,Carolina Panthers,Cornerback,0,2013/2014,1,71,65,6
Josh Wilson,Detroit Lions,Cornerback,1,2015/2016,2,34,12,22
Josh Wilson,Washington Redskins,Cornerback,0,2012/2013,0,80,70,10
Joshua Cribbs,Cleveland Browns,Wide Receiver,0,2012/2013,0,24,27,-3
JR Sweezy,Seattle Seahawks,Guard,0,2015/2016,1,71,60,11
Julian Edelman,New England Patriots,Wide Receiver,1,2012/2013,0,41,59,-18
Justin Bethel,Arizona Cardinals,Cornerback,1,2013/2014,0,21,17,4
Justin Coleman,New England Patriots,Cornerback,0,2015/2016,1,32,67,-35
Justin Gilbert,Cleveland Browns,Defensive Back,0,2015/2016,4,23,8,15
Justin Houston,Kansas City Chiefs,Linebacker,1,2013/2014,0,68,76,-8
Justin Hunter,Tennessee Titans,Wide Receiver,0,2013/2014,0,17,39,-22
Justin Pugh,New York Giants,Guard,0,2015/2016,2,69,67,2
K.J. Wright,Seattle Seahawks,Linebacker,1,2012/2013,1,74,71,3
K'Waun Williams,Cleveland Browns,Cornerback,1,2014/2015,1,27,15,12
K'waun Williams,Cleveland Browns,Cornerback,1,2015/2016,2,49,45,4
Ka'Deem Carey,Chicago Bears,Running Back,0,2015/2016,1,13,10,3
Kamar Aiken,Baltimore Ravens,Wide Receiver,1,2014/2015,0,18,33,-15
Karlos Williams,Buffalo Bills,Running Back,0,2015/2016,3,22,23,-1
Keith Brooking,Denver Broncos,Linebacker,0,2012/2013,0,34,37,-3
Keith Tandy,Tampa Bay Buccaneers,Safety,0,2013/2014,0,18,43,-25
Keith Tandy,Tampa Bay Buccaneers,Safety,1,2015/2016,1,29,19,10
Kelvin Benjamin,Carolina Panthers,Wide Receiver,1,2014/2015,0,58,52,6
Kendall Gaskins,San Francisco 49ers,Running Back,0,2015/2016,0,28,47,-19
Kendall Wright,Tennessee Titans,Wide Receiver,0,2013/2014,0,19,45,-26
Kenneth Acker,San Francisco 49ers,Cornerback,0,2015/2016,1,79,46,33
Kenny Vaccaro,New Orleans Saints,Safety,1,2013/2014,1,67,68,-1
Kenny Vaccaro,New Orleans Saints,Safety,1,2013/2014,0,68,57,11
Kevin Boss,Kansas City Chiefs,Tight End,0,2012/2013,14,37,0,37
Kevin Ogletree,Dallas Cowboys,Wide Receiver,1,2012/2013,1,35,21,14
Kevin Rutland,Jacksonville Jaguars,Cornerback,1,2012/2013,2,20,6,14
King Dunlap,San Diego Chargers,Tackle,0,2013/2014,2,74,80,-6
King Dunlap,San Diego Chargers,Tackle,0,2015/2016,3,76,78,-2
Kyle Arrington,New England Patriots,Cornerback,1,2012/2013,0,74,86,-12
Kyle Emmanuel,San Diego Chargers,Linebacker,1,2015/2016,0,31,49,-18
Kyle Emmanuel,San Diego Chargers,Linebacker,1,2015/2016,2,34,0,34
Kyle Love,Carolina Panthers,Defensive Tackle,1,2015/2016,1,25,24,1
Kyle Rudolph,Minnesota Vikings,Tight End,0,2012/2013,0,63,47,16
Kyle Wilson,New York Jets,Cornerback,0,2013/2014,0,54,70,-16
LaAdrian Waddle,Detroit Lions,Tackle,1,2014/2015,1,54,48,6
Ladarius Green,San Diego Chargers,Tight End,1,2015/2016,0,0,0,0
Ladarius Green,San Diego Chargers,Tight End,0,2015/2016,1,68,58,10
LaMar Miller,Miami Dolphins,Running Back,1,2013/2014,0,41,38,3
Lamin Barrow,Denver Broncos,Linebacker,1,2014/2015,0,29,30,-1
Lance Kendricks,St. Louis Rams,Tight End,0,2015/2016,0,41,43,-2
Landry Jones,Pittsburgh Steelers,Quarterback,0,2015/2016,0,0,0,0
LaRon Byrd,Arizona Cardinals,Wide Receiver,0,2012/2013,2,1,20,-19
LaRon Landry,Indianapolis Colts,Safety,1,2013/2014,0,66,73,-7
Larry Fitzgerald,Arizona Cardinals,Wide Receiver,1,2013/2014,0,62,64,-2
Larry Warford,Detroit Lions,Guard,1,2015/2016,0,60,68,-8
Latavius Murray,Oakland Raiders,Running Back,0,2015/2016,1,40,38,2
Laurent Duvernay-Tardif,Kansas City Chiefs,Guard,1,2015/2016,1,56,0,56
Laurent Robinson,Jacksonville Jaguars,Wide Receiver,0,2012/2013,3,39,45,-6
Laurent Robinson,Jacksonville Jaguars,Wide Receiver,1,2012/2013,0,56,26,30
Lawrence Jackson,Detroit Lions,Defensive End,0,2012/2013,0,28,33,-5
Le'Veon Bell,Pittsburgh Steelers,Running Back,0,2013/2014,0,52,55,-3
Leon Hall,Cincinnati Bengals,Cornerback,1,2015/2016,0,51,61,-10
LeSean McCoy,Philadelphia Eagles,Running Back,0,2012/2013,4,60,64,-4
Luke Joeckel,Jacksonville Jaguars,Tackle,0,2014/2015,0,68,66,2
Luke Kuechly,Carolina Panthers,Linebacker,1,2015/2016,3,0,67,-67
Luke Stocker,Tampa Bay Buccaneers,Tight End,0,2012/2013,0,38,45,-7
Luke Wilson,Seattle Seahawks,Tight End,0,2015/2016,2,44,57,-13
Malcolm Jenkins,Philadelphia Eagles,Safety,1,2015/2016,0,84,71,13
Malcom Floyd,San Diego Chargers,Wide Receiver,1,2015/2016,0,66,70,-4
Malik Jackson,Denver Broncos,Defensive End,1,2015/2016,0,0,55,-55
Marcus Easley,Buffalo Bills,Wide Receiver,0,2015/2016,1,22,24,-2
Marcus Gilbert,Pittsburgh Steelers,Tackle,1,2014/2015,1,67,75,-8
Marcus Martin,San Francisco 49ers,Center,0,2015/2016,2,60,0,60
Mark Barron,St. Louis Rams,Safety,1,2015/2016,0,64,88,-24
Marlon Moore,Cleveland Browns,Wide Receiver,0,2015/2016,1,28,0,28
Marquise Goodwin,Buffalo Bills,Wide Receiver,0,2014/2015,1,18,25,-7
Marshall Newhouse,New York Giants,Tackle,0,2015/2016,1,72,0,72
Martin Tevaseu,Indianapolis Colts,Defensive Tackle,1,2012/2013,0,14,24,-10
Mason Foster,Tampa Bay Buccaneers,Linebacker,1,2013/2014,1,56,60,-4
Matt Cassel,Kansas City Chiefs,Quarterback,0,2012/2013,1,77,51,26
Matt Conrath,St. Louis Rams,Defensive Tackle,0,2013/2014,5,20,23,-3
Matt Giordano,Oakland Raiders,Safety,0,2012/2013,0,59,66,-7
Matt Giordano,Oakland Raiders,Safety,0,2012/2013,0,61,87,-26
Matthew Slater,New England Patriots,Wide Receiver,1,2012/2013,0,19,20,-1
Max Unger,Seattle Seahawks,Center,1,2013/2014,1,64,45,19
Maxx Williams,Baltimore Ravens,Tight End,0,2015/2016,1,32,27,5
Melvin White,Carolina Panthers,Cornerback,1,2013/2014,0,29,58,-29
Michael Hoomanawanui,New England Patriots,Tight End,1,2012/2013,2,18,20,-2
Michael Johnson,Cincinnati Bengals,Defensive End,0,2013/2014,1,59,66,-7
Michael Mitchell,Pittsburgh Steelers,Safety,1,2015/2016,0,71,71,0
Michael Vick,Philadelphia Eagles,Quarterback,0,2012/2013,6,73,60,13
Mike Brisiel,Oakland Raiders,Guard,0,2012/2013,0,66,85,-19
Mike Brisiel,Oakland Raiders,Guard,0,2012/2013,1,68,0,68
Mike DeVito,Kansas City Chiefs,Defensive End,0,2015/2016,2,27,32,-5
Mike DeVito,Kansas City Chiefs,Defensive End,1,2015/2016,1,28,23,5
Mike Iupati,Arizona Cardinals,Guard,1,2015/2016,0,71,53,18
Mike Iupati,San Francisco 49ers,Guard,1,2014/2015,1,73,71,2
Mike Jenkins,Oakland Raiders,Cornerback,0,2013/2014,0,66,48,18
Mike Mitchell,Oakland Raiders,Safety,0,2012/2013,0,32,49,-17
Mike Tolbert,Carolina Panthers,Full Back,1,2012/2013,0,33,22,11
Mitch Morse,Kansas City Chiefs,Center,1,2015/2016,2,63,0,63
Mitch Morse,Kansas City Chiefs,Center,1,2015/2016,1,67,57,10
Montell Owens,Jacksonville Jaguars,Running Back,1,2012/2013,0,33,18,15
Morris Claiborne,Dallas Cowboys,Cornerback,1,2012/2013,1,59,93,-34
Muhammad Wilkerson,New York Jets,Defensive End,0,2012/2013,0,61,63,-2
Mychal Kendricks,Philadelphia Eagles,Linebacker,0,2012/2013,1,63,0,63
Mychal Rivera,Oakland Raiders,Tight End,0,2013/2014,0,52,42,10
Nate Eachus,Kansas City Chiefs,Running Back,0,2012/2013,1,29,32,-3
Nate Irving,Denver Broncos,Linebacker,0,2012/2013,1,22,24,-2
Nate Livings,Dallas Cowboys,Guard,1,2012/2013,0,74,72,2
Nate Solder,New England Patriots,Tackle,0,2013/2014,1,79,81,-2
Nate Solder,New England Patriots,Tackle,1,2013/2014,0,79,52,27
Nevin Lawson,Detroit Lions,Cornerback,1,2015/2016,0,21,54,-33
Nick Fairley,St. Louis Rams,Defensive Tackle,1,2015/2016,1,31,0,31
Nick Foles,Philadelphia Eagles,Quarterback,0,2013/2014,1,30,51,-21
Nick Kasa,Oakland Raiders,Tight End,0,2013/2014,0,7,11,-4
Niles Paul,Washington Redskins,Tight End,0,2014/2015,0,62,48,14
Nolan Carroll,Miami Dolphins,Cornerback,1,2013/2014,0,59,73,-14
O'Brien Schofield,Seattle Seahawks,Defensive End,1,2014/2015,0,34,35,-1
Omar Bolden,Denver Broncos,Cornerback,1,2012/2013,0,23,12,11
Omar Bolden,Denver Broncos,Cornerback,1,2014/2015,1,24,17,7
Omar Bolden,Denver Broncos,Safety,0,2013/2014,0,22,25,-3
Orlando Franklin,San Diego Chargers,Guard,0,2015/2016,1,66,0,66
Patrick Peterson,Arizona Cardinals,Cornerback,1,2014/2015,0,66,68,-2
Patrick Robinson,San Diego Chargers,Cornerback,0,2015/2016,0,54,24,30
Paul Posluszny,Jacksonville Jaguars,Linebacker,1,2013/2014,1,74,60,14
Paul Soliai,Atlanta Falcons,Defensive Tackle,0,2015/2016,0,31,36,-5
Percy Harvin,Seattle Seahawks,Wide Receiver,1,2013/2014,1,21,31,-10
Peyton Hillis,New York Giants,Running Back,0,2013/2014,1,25,41,-16
Phil Loadholt,Minnesota Vikings,Tackle,0,2013/2014,1,66,78,-12
Phil Taylor,Cleveland Browns,Tackle,0,2013/2014,1,42,0,42
Phillip Adams,Oakland Raiders,Cornerback,0,2012/2013,0,21,61,-40
Phillip Adams,Oakland Raiders,Cornerback,1,2012/2013,0,24,25,-1
Phillip Gaines,Kansas City Chiefs,Cornerback,0,2014/2015,0,14,49,-35
Pierre Desir,Cleveland Browns,Cornerback,1,2015/2016,0,0,0,0
Quinton Patton,San Francisco 49ers,Wide Receiver,0,2015/2016,0,36,24,12
Ramon Foster,Pittsburgh Steelers,Guard,0,2013/2014,0,58,80,-22
Ramses Barden,New York Giants,Wide Receiver,0,2012/2013,1,42,13,29
Rashad Jennings,Jacksonville Jaguars,Running Back,0,2012/2013,4,38,0,38
Rashad Jennings,Oakland Raiders,Running Back,0,2013/2014,1,43,62,-19
Rashean Mathis,Detroit Lions,Cornerback,1,2013/2014,0,50,68,-18
Rashean Mathis,Detroit Lions,Cornerback,0,2015/2016,3,68,39,29
Raymond Ventrone,San Francisco 49ers,Safety,0,2013/2014,0,20,25,-5
Red Bryant,Seattle Seahawks,Defensive End,1,2013/2014,1,36,39,-3
Reed Doughty,Washington Redskins,Safety,1,2013/2014,1,47,29,18
Reed Doughty,Washington Redskins,Safety,0,2013/2014,0,49,57,-8
Reggie Walker,Arizona Cardinals,Linebacker,0,2012/2013,2,29,20,9
Reid Fragel,Tampa Bay Buccaneers,Tackle,0,2015/2016,10,34,0,34
Rhett Ellison,Minnesota Vikings,Tight End,1,2015/2016,1,45,70,-25
Robert Griffin III,Washington Redskins,Quarterback,1,2015/2016,0,0,0,0
Robert Griffin III,Washington Redskins,Quarterback,0,2012/2013,0,71,58,13
Robert Quinn,St. Louis Rams,Defensive End,1,2012/2013,0,63,20,43
Rolando McClain,Dallas Cowboys,Linebacker,0,2015/2016,1,57,62,-5
Rolando McClain,Oakland Raiders,Linebacker,0,2012/2013,0,61,78,-17
Ron Brooks,Buffalo Bills,Cornerback,1,2015/2016,2,19,46,-27
Roy Miller,Tampa Bay Buccaneers,Defensive Tackle,0,2012/2013,1,41,29,12
Ryan Clark,Pittsburgh Steelers,Safety,1,2012/2013,0,58,64,-6
Ryan Clark,Pittsburgh Steelers,Safety,1,2012/2013,0,63,58,5
Ryan Griffin,Houston Texans,Tight End,0,2013/2014,1,29,33,-4
Ryan Mathews,San Diego Chargers,Running Back,0,2013/2014,0,25,40,-15
Ryan Matthews,Philadelphia Eagles,Running Back,0,2015/2016,3,19,20,-1
Ryan Shazier,Pittsburgh Steelers,Linebacker,0,2015/2016,0,69,47,22
Ryan Wendell,New England Patriots,Center,0,2013/2014,0,79,92,-13
Sam Bradford,Philadelphia Eagles,Quarterback,0,2015/2016,2,73,61,12
Sam Shields,Green Bay Packers,Cornerback,1,2015/2016,4,67,70,-3
Santana Moss,Washington Redskins,Wide Receiver,0,2012/2013,0,29,22,7
Scott Chandler,Buffalo Bills,Tight End,0,2012/2013,0,59,43,16
Scott Crichton,Minnesota Vikings,Defensive End,0,2015/2016,4,26,0,26
Sean Lee,Dallas Cowboys,Linebacker,0,2015/2016,1,58,53,5
Sean Lee,Dallas Cowboys,Linebacker,0,2015/2016,0,67,67,0
Sean Lissemore,San Diego Chargers,Tackle,0,2015/2016,0,31,18,13
Seantrel Henderson,Buffalo Bills,Tackle,0,2015/2016,1,68,55,13
Sebastion Vollmer,New England Patriots,Tackle,1,2015/2016,0,64,70,-6
Sebastion Vollmer,New England Patriots,Tackle,0,2015/2016,1,67,55,12
Seyi Ajirotutu,Philadelphia Eagles,Wide Receiver,0,2015/2016,1,0,28,-28
Shawn Lauvao,Cleveland Browns,Guard,0,2012/2013,0,70,66,4
Shea McClellin,Chicago Bears,Defensive End,0,2012/2013,1,31,27,4
Shea McClellin,Chicago Bears,Linebacker,0,2015/2016,1,67,11,56
Sheldon Brown,Cleveland Browns,Cornerback,0,2012/2013,1,61,0,61
Sherrick McManis,Chicago Bears,Cornerback,0,2015/2016,0,37,24,13
Sidney Rice,Seattle Seahawks,Wide Receiver,1,2012/2013,0,49,44,5
Stanley Havili,Indianapolis Colts,Full Back,1,2013/2014,1,40,45,-5
Stephen Burton,Jacksonville Jaguars,Wide Receiver,0,2013/2014,5,43,22,21
Stephen Burton,Jacksonville Jaguars,Wide Receiver,1,2013/2014,7,45,0,45
Stephen Hill,New York Jets,Wide Receiver,0,2013/2014,0,70,31,39
Steve Vallos,Denver Broncos,Center,1,2013/2014,1,8,7,1
Steve Williams,San Diego Chargers,Cornerback,0,2015/2016,0,27,14,13
T.J. Lang,Green Bay Packers,Guard,1,2012/2013,0,70,87,-17
T.J. Lang,Green Bay Packers,Guard,0,2013/2014,0,77,84,-7
T.J. McDonald,St. Louis Rams,Safety,1,2014/2015,0,74,75,-1
Taylor Gabriel,Cleveland Browns,Wide Receiver,1,2015/2016,3,35,46,-11
Taylor Lewan,Tennessee Titans,Tackle,0,2015/2016,1,65,0,65
Teddy Bridgewater,Minnesota Vikings,Quarterback,1,2015/2016,0,65,62,3
Teddy Williams,Carolina Panthers,Cornerback,1,2015/2016,0,24,20,4
Terence Newman,Cincinnati Bengals,Cornerback,1,2012/2013,0,62,63,-1
Terrell McClain,Dallas Cowboys,Defensive Tackle,1,2014/2015,1,20,18,2
Terrelle Pryor,Oakland Raiders,Quarterback,0,2013/2014,1,63,58,5
Terrence Newman,Minnesota Vikings,Cornerback,1,2015/2016,0,63,53,10
Terron Armstead,New Orleans Saints,Tackle,0,2014/2015,0,76,89,-13
Theo Riddick,Detroit Lions,Running Back,0,2013/2014,2,23,20,3
Thomas DeCoud,Atlanta Falcons,Safety,0,2013/2014,1,78,66,12
Tim Barnes,St. Louis Rams,Center,0,2015/2016,0,60,61,-1
Tiquan Underwood,Tampa Bay Buccaneers,Wide Receiver,1,2012/2013,0,26,29,-3
Tom Johnson,Minnesota Vikings,Defensive Tackle,1,2015/2016,0,46,41,5
Tony Jefferson,Arizona Cardinals,Safety,1,2014/2015,0,65,33,32
Tony Moeaki,Kansas City Chiefs,Tight End,0,2012/2013,1,63,36,27
Tony Scheffler,Detroit Lions,Tight End,0,2013/2014,11,16,0,16
Torrey Smith,Baltimore Ravens,Wide Receiver,0,2012/2013,0,61,75,-14
Tracy Porter,Oakland Raiders,Cornerback,0,2013/2014,0,63,68,-5
Tracy Porter,Denver Broncos,Cornerback,1,2012/2013,2,64,0,64
Tramon Williams,Cleveland Browns,Cornerback,0,2015/2016,1,71,0,71
Tray Walker,Baltimore Ravens,Cornerback,0,2015/2016,2,14,10,4
Trent Cole,Indianapolis Colts,Linebacker,1,2015/2016,1,44,0,44
Trent Williams,Washington Redskins,Tackle,0,2015/2016,0,74,58,16
Trevin Wade,New York Giants,Cornerback,0,2015/2016,0,21,55,-34
Trevor Robinson,San Diego Chargers,Center,0,2015/2016,0,66,33,33
Trumaine Johnson,St. Louis Rams,Cornerback,1,2015/2016,0,0,72,-72
Trumaine Johnson,St. Louis Rams,Cornerback,1,2013/2014,0,57,65,-8
Tyler Eifert,Cincinnati Bengals,Tight End,0,2015/2016,2,64,37,27
Tyler Polumbus,Washington Redskins,Tackle,1,2012/2013,1,65,62,3
Tyler Varga,Indianapolis Colts,Running Back,1,2015/2016,13,29,0,29
Uche Nwaneri,Jacksonville Jaguars,Guard,0,2012/2013,1,67,0,67
Usama Young,Cleveland Browns,Safety,1,2012/2013,1,56,28,28
Vance McDonald,San Francisco 49ers,Tight End,1,2015/2016,1,39,43,-4
Vance Walker,Oakland Raiders,Defensive Tackle,0,2013/2014,1,56,60,-4
Vernon Davis,San Francisco 49ers,Tight End,0,2013/2014,0,47,56,-9
Vernon Davis,Denver Broncos,Tight End,1,2015/2016,0,48,60,-12
Vernon Davis,San Francisco 49ers,Tight End,0,2012/2013,0,60,60,0
Vince Williams,Pittsburgh Steelers,Linebacker,0,2013/2014,0,43,33,10
Virgil Green,Denver Broncos,Tight End,0,2014/2015,0,43,23,20
Vontae Davis,Indianapolis Colts,Cornerback,0,2015/2016,0,58,76,-18
Vontaze Burfict,Cincinnati Bengals,Linebacker,1,2014/2015,2,23,80,-57
Vontaze Burfict,Cincinnati Bengals,Linebacker,1,2013/2014,0,70,69,1
Wallace Gilberry,Cincinnati Bengals,Defensive End,1,2013/2014,0,36,33,3
Wes Welker,Denver Broncos,Wide Receiver,1,2013/2014,3,61,68,-7
Will Allen,Pittsburgh Steelers,Safety,0,2015/2016,0,0,96,-96
Will Blackmon,Jacksonville Jaguars,Cornerback,0,2013/2014,0,62,75,-13
Will Johnson,Pittsburgh Steelers,Full Back,1,2012/2013,0,34,20,14
Will Rackley,Jacksonville Jaguars,Guard,0,2013/2014,2,63,72,-9
Will Tukuafu,San Francisco 49ers,Defensive Tackle,1,2012/2013,0,23,13,10
Will Tukuafu,Seattle Seahawks,Running Back,0,2015/2016,0,24,13,11
William Gay,Pittsburgh Steelers,Cornerback,1,2015/2016,0,71,52,19
William Gholston,Tampa Bay Buccaneers,Defensive End,1,2013/2014,0,22,42,-20
William Gholston,Tampa Bay Buccaneers,Defensive End,1,2015/2016,0,45,71,-26
William Middleton,Jacksonville Jaguars,Cornerback,0,2012/2013,6,29,0,29
William Powell,Arizona Cardinals,Running Back,0,2012/2013,0,40,35,5
Willis McGahee,Cleveland Browns,Running Back,0,2013/2014,1,24,2,22
Winston Justice,Indianapolis Colts,Tackle,1,2012/2013,0,71,33,38
Xavier Rhodes,Minnesota Vikings,Cornerback,1,2015/2016,0,82,60,22
Xavier Rhodes,Minnesota Vikings,Wide Receiver,1,2013/2014,0,53,76,-23
Zac Stacy,St. Louis Rams,Running Back,1,2013/2014,0,37,55,-18
Zach Ertz,Philadelphia Eagles,Tight End,0,2015/2016,1,61,58,3